H|:HHHHHHHHHHHHHHHH|:HH
U|:................|:..
.|:k.k..........k.k|:..
.|:HHH..........HHH|:..
._+................^+..
.......................
..>....................
.......$...c...$.......
......$.$.$.$.$.$...K..
.....$.$.$.$.$.$.$.{}..
....$.$.$.$.$.$.$.$[]z.
~~~~~~~~~~~~~~~~~~}[]{~
DDDDDDDDDDDDDDDDDDDDDDD
DDDDDDDDDDDDDDDDDDDDDDD