.....................
.....................
.....................
.....................
....I................
......HHHHHHHHHHH$$HH
......H.............H
...1..H.............H
HH/=HHH.............H
..|:.................
..|:.................
..|:..>..............
.(|:MMMM)...c....-=..
.[|:DDDD].$.H....|:..
.[|:DDDD].H.H.HHH|:HH
.[|:DDDD].H.H.HDD|:DD