""""""""HH""""""""""""""""""""
U......$HH....................
........HH$...................
...T...$HH....................
.....-=.HH$...................
.2...|:$HH...........I....>...
~~~~~|:~HH$.tC.t..............
DDDDD|:DHH................/=..
DDDDD|:DHH$.............z.|:..
DDDDD|:DHH~~~~~~~~~~~~~~~~|:~~
DDDDD|:DHHDDDDDDDDDDDDDDDD|:DD
DDDDD|:DHHDDDDDDDDDDDDDDDD|:DD.