SsSsSsSsSsSsSsSsSsSsSsSsSsSsSsSsSsSsSsSsSsSsSsSsSsSsSsSsSsSsSsSsSsy.SsSsSsSsSsSsSsSsSsSsSs|:SsSsSsSsSsSsSsSsSsSsSsSsSsSsSsSsSsSsSsSsSsSsSsSsSsSsSsSsSsSsSsSsSsy.SsSsSs.Ss..................
sSsSsSsSsSsSsSsSsSsSsSsSsSsSsSsSsSsSsy.SsSsSsSsSsy.SsSsSsSsSsSsSs....SsSsSsSsSsSsSsSsSsSsS|:sSsSsSsSsSsSsSsSsSsSsSsSsSsSsSsSsSsSsSsSsSsSsSsSsSsSsSsSsSsSsSsSs....SsSs..Ss..................
SsSsSsSsSsSsSsSsSsSsSsSsSsSsSsSsSsSs....SsSsSsSs....SsSsSsSsSsSs......SsSsSsSsy.SsSsSsSsSs|:SsSsSsSsSsSsSsSsSsSsSsSsSsSsSsSsSsSsSsSsSsSsSsSsSsSsSsy.SsSsSsSs......Ss...Ss..................
x..............x............................................................Ss..Ssx.......|:...........................................................................Ss..................
...................x......................................................................_+..........................................................................Sss..................
......................x.................................................................................................B.g.B.B.g.B.B.g.B............................SsSs................z.
...........T............x...................T.........................................T....1..............T...........................................T.............SsSsSs.............SsMM
..............................................................................$$....................x..............................................................SsSsSsSs...........SssDD
...>..........................................................................Ss..........................!.............k....k.....k....k.........................SsSsSsSsSs.........SsSsDD
sSsSsSsSsSsSsSsSsSsSsSsSsSsSsSsSsSsSsSsSsSsSsSsSsSsSs......SsSsSsSsSsSsSsSsSsSsSsSsSsSsSsSsSsSsSsSsSsSsSsSs..SsSsSsSsSsSsSsSsSsSsSsSsSsSs....SsSsSsSsSsSsSsSsSsSsSsSsSsSs(MMMMMMMMMMMMMMMMM
SsSsSsSsSsSsSsSsSsSsSsSsSsSsSsSsSsSsSsSsSsSsSsSsSsSsSs......SsSsSsSsSsSsSsSsSsSsSsSsSsSsSsSsSsSsSsSsSsSsSsSs..SsSsSsSsSsSsSsSsSsSsSsSsSsSs....SsSsSsSsSsSsSsSsSsSsSsSsSs[DDDDDDDDDDDDDDDDDD
sSsSsSsSsSsSsSsSsSsSsSsSsSsSsSsSsSsSsSsSsSsSsSsSsSsSsSs......SsSsSsSsSsSsSsSsSsSsSsSsSsSsSsSsSsSsSsSsSsSsSs..SsSsSsSsSsSsSsSsSsSsSsSsSsSsSs...oSsSsSsSsSsSsSsSsSsSsSsSsS[DDDDDDDDDDDDDDDDDD
SsSsSsSsSsSsSsSsSsSsSsSsSsSsSsSsSsSsSsSsSsSsSsSsSsSsSs......SsSsSsSsSsSsSsSsSsSsSsSsSsSsSsSsSsSsSsSsSsSsSsSs..SsSsSsSsSsSsSsSsSsSsSsSsSsSsSsU.o.SsSsSsSsSsSsSsSsSsSssc.c[DDDDDDDDDDDDDDDDDD
sSsSsSsSsSsSsSsSsSsSsSsSsSsSsSsSsSsSsSsSsSsSsSsSsSsSsSs......SsSsSsSsSsSsSsSsSsSsSsSsSsSsSsSsSsSsSsSsSsSsSs..SsSsSsSsSsSsSsSsSsSsSsSsSsSsSss..o..SsSsSsSsSsSsSsSsSsSs...[DDDDDDDDDDDDDDDDDD
SsSsSsSsSsSsSsSsSsSsSsSsSsSsSsSsSsSsSsSsSsSsSsSsSsSsSs......SsSsSsSsSsSsSsSsSsSsSsSsSsSsSsSsSsSsSsSsSsSsSsSs..SsSsSsSsSsSsSsSsSsSsSsSsSsSsSs..o...SsSsSsSsSsSsSsSsSs....[DDDDDDDDDDDDDDDDDD
o.....o.....o.....o.....o.....o....o....o.....o.....o........SsSsSsSsSsSsSsSsSsSsSsSsSsSsSsSsSsSsSsSsSsSsSs..SsSsSsSsSsSsSsSsSsSsSsSsSsSsSss..o....SsSsSsSsSsSsSsSs...-=[DDDDDDDDDDDDDDDDDD
o.....o.....o.....o.....o.....o....o....o.....o.....o.......SsSsSsSsSsSsSsSsSsSsSsSsSsSsSsSsSsSsSsSsSsSsSs....SsSsSsSsSsSsSsSsSsSsSsSsSsSsSs..o....oSsSsSsSsSsSsSs....|:[DDDDDDDDDDDDDDDDDD
o.....o.....o.....o.....o.....o....o....o.....o.....o........SsSsSsSsSsSsSsSsSsSsSsSsSsSsSsSsSsSsSsSsSsSs....SsSsSsSsSsSsSsSsSsSsSsSsSsSsSss..o....o.SsSsSsSsSsSso....|:[DDDDDDDDDDDDDDDDDD
o.....o.....o.....o.....o.....o....o....o.....o.....o.......SsSsSsSsSsSsSsSsSsSsSsSsSsSsSsSsSsSsSsSsSsSs.tC.t.SsSsSsSsSsSsSsSsSsSsSsSsSsSsSs..o....o.............o....SsSsDDDDDDDDDDDDDDDDD
o.....o.....o.....o.....o.....o....o....o.....o.....o........SsSsSsSsSsSsSsSsSsSsSsSsSsSsSsSsSsSsSsSsSso.....SsSsSsSsSsSsSsSsSsSsSsSsSsSsSss..o....o.............o...SsSsDDDDDDDDDDDDDDDDDD
o.....o.....o.....o.....o.....o....o....o.....o.....o.......SsSsSsSsSsSsSsSsSsSsSsSsSsSsSsSsSsSsSsSsSs.o......SsSsSsSsSsSsSsSsSsSsSsSsSsSsSs..o....o..2.$.$.$.$.$o$.SsSsSs[DDDDDDDDDDDDDDDD
o.....o.....o.....o.....o.....o....o....o.....o.....o........SsSsSsSsSsSsSsSsSsSsSsSsSsSsSsSsSsSsSsSs..o.SsSsSsSsSsSsSsSsSsSsSsSsSsSsSsSsSss..o....o.SsSsSsSsSsSsSsSss.o..[DDDDDDDDDDDDDDDD
o.....o.....o.....o.....o.....o....o....o.....o.....o.......SsSsSsSsSsSsSsSsSsSsSsSsSsSsSsSsSsSsSsSsSs.o..SsSsSsSsSsSsSsSsSsSsSsSsSsSsSsSsSs..o....o.[DDDDDDDDDDDDDDSs.o..[DDDDDDDDDDDDDDDD.