]U|:.............|:.[
].|:.............|:.[
].|:.............|:.[
].|:.............|:.[
].|:.............|:.[
].|:.............|:.[
].|:.............|:.[
].^+......T......_+.[
]...................[
].....a...a...a..>..[
]....z.z.z.z.z.z....[
]{~~~~~~~~~~~~~~~~~}[.
