]U|:.............|:.[
].|:.............|:.[
].|:.............|:.[
].|:.............|:.[
].|:.............|:.[
].|:.............|:.[
].|:.............|:.[
].^+......c......_+.[
]...................[
]................>..[
].z.................[
]{~~~~~~}...{~~~~~~}[.
