|:HHHHHHHHHHHHHHHHHHHHH|:
|:HHHHHHHHHy.HHHHHHHHHH|:
|:H....................|:
|:H....................|:
_+H....................|:
..H....................|:
.>H....................|:
..H....................|:
..H....$........$......|:
..H.a.$c$z.....$c$.....|:
..HHHHHHHHeaaeHHHHH....|:
..HHHHHHHHHHHHHHHHH$...^+
..................HH.....
.........................
W.$.$.$.$.$.$.$.$.$.$.$..
.$.$.$.$.$.$.$.$.$.$.$.$.
BBBBBBBBBBBBBBBBBBBBBBBBB
BBBBBBBBBBBBBBBBBBBBBBBBB.