W|:[DDDDDDDDDDDDDDDDDDDDDD].[D
.|:[DDDDDDDDDDDDDDDDDDDDDD]$[D
.|:[DDDDDDDDDDDDDDDDDDDDDD].[D
._+[DDDDDDDDDDDDDDDDDDDDDD]$[D
...[DDDDDDDDDDDDDDDDDDDDDD].[D
..>[DDDDDDDDDDDDD|:DDDDDDD]$[D
...[DDDDDDDDDDD]`|:"""""""'.`"
...[DDDDDDDDDDD].|:........$..
...[DDDDDDDDDDD].^+...........
...[DDDDDDDDDDD]...........$..
...[DDDDDDDDDDD]..............
...[DDDDDDDDDDD]...........z..
.c.[DDDDDDDDDDD]{~~~~~~~~~~~~~
...[DDDDDDDDDDDDDDDDDDDDDDDDD]
.c.[DDDDDDDDDDDDDDDDDDDDDDDDD]
...[DDDDDDDDDDDDDDDDDDDDDDDDD]