.|:.[DDDDDDDDDDDDDDDDDDDDDDDDDDDDDDDDDDDDDDDDDDDDDDDDDDDDDDDDDDDDDDDDD|:DD
.|:.[DDDDDDDDDDDDDDDDDDDDDDDDDDDDDDDDDDDDDDDDDDDDDDDDDDDDDDDDDDDDDDDDD|:DD
.|:.[DDDDDDDDDDDDDDDDDDDDDDDDDDDDDDDDDDDDDDDDDDDDDDDDDDDDDDDDDDDDDDDDD|:DD
._+.[DDDDDDDDDDDDDDDDDDDDDDDDDDDDDDDDDDDDDDDDDDDDDDDDDDDDDDDDDDDDDDDDD|:DD
....[DDDDDDDDDDDDDDDDDDDDDDDDDDDDDDDDDDDDDDDDDDDDDDDDDDDDDDDDDDDDDDDDD|:DD
....[DDDDDDDDDDDDDDDDDDDDDDDDDDDDDDDDDDDDDDDDDDDDDDDDDDDDDDDDDDDDDDDDD|:DD
..>.[DDDDDDDDDDDDDDDDDDDDDDDDDDDDDDDDDDDDDDDDDDDDDDDDDDDDDDDDDDDDDDDDD|:DD
....[DDDDDDDDDDDDDDDDDDDDDDDDDDDDDDDDDDDDDDDDDDDDDDDDDDDDDDDDDDDDDDDDD|:DD
....[DDDDDDDDDDDDDDDDDDDDDDDDDDDDDDDDDDDDDDDDDDDDDDDDDDDDDDDDDDDDDDDDD|:DD
..$.[DDDDDDDDDDDDDDDDDDDDDDDDDDDDDDDDDDDDDDDDDDDDDDDDDDDDDDDDDDDDDDDDD|:DD
....`"""""""""""""""""""""""""""""""""""""""""""""""""""""""""""""""""|:""
..$...................................................................|:..
.................................$.$..................................^+,.
..$.$.$...........................$...............$....$..................
~~~~~~}..........................$.$.........$....$....$..................
""""""'.........................{~~~}...$....$....$....$.......z..........
....................???.........[DDD]...$....$...{~}..{~~~~~~~~~~~~~~~~~~~
................................[DDD]...$...{~}..`"'..`"""""""""""""""""""
.......{~~}......$.$.$.$.$......[DDD]..{~}..`"'...........................
.......[DD]..{~~~~~~~~~~~~~~~}..[DDD]..`"'................................
.......[DD]..[DDDDDDDDDDDDDDD]..[DDD]......................................