.|:..................
.^+..................
.....................
.....................
.....................
.>...................
o\.....%..%..%.......
ww\....P..P..P.....<.
www\...;..;..;.../ooo
wwww\..;..;..;../wwww
wwwwwooooooooooowwwww
wwwwwwwwwwwwwwwwwwwww.