H.|:................H
H.|:................H
H._+................H
H...................H
H..>................H
H................-=.H
H................|:.H
H................|:.H
H...............H|:HH
H...............H|:HH
HHHHHHHHHHHHHHHHH|:HH
HHHHHHHHHHHHHHHHH|:HH