.....................
.....................
.....................
.....................
.....................
.....................
................T...T
.....................
..>...........C......
MMMMMMMMMMMMMMMMMMMMM
DDDDDDDDDDDDDDDDDDDDD
DDDDDDDDDDDDDDDDDDDDD.